1111111111111111
1E00000000000001
1010010100100101
1010010000100101
1C00000000C00001
1000000000000001
1000000000000001
1000000000000001
1C00000000C00001
1010010000100101
1010010100100101
1E00000000000001
1111111111111111

