11111111111111111111111
1C000000000000000010001
1000000000000100001C001
1111110000111100C010001
10E00000011110C00010001
1111111100011100P010001
10000000000011000010001
10C00000000011000010001
1101110000111100000C001
10000000001C00000000001
11111111111111111111111
